0
burst out - вспыхнуть, воскликнуть
come across - повстречаться, натолкнуться
knock down - сбить, свалить, снести
let down - опускать, ослабить, разочаровать
look after - ухаживать, присмотреть, проследить
calm down - успокаиваться, утихомирить
check in - регистрировать, записываться
back off - отстраниться, пойти на попятный, отступить
go after - добиваться
switch off/on - выключать/включать
think over - обдумывать
take away - забрать, убрать
come along - идти вместе, сопровождать
throw up - бросать, кидаться
break down - ломать, ухудшаться, не выдерживать
make up - составить, придумать, мириться, гримировать
pick up - поднять, подцепить, забрать, познакомиться,
sign up - поступить/нанимать на работу, записываться
turn up - оказаться, загибаться, приподниматься
take oveк - завладеть, замещать, заступить
be back - возвращаться, вернуться
look out - Осторожнее! смотреть в оба, выглядывать
pay off - окупиться, расплатиться, рассчитаться полностью
give up - сдаваться, бросать, уступать
go off - сходить, уходить, уезжать
settle down - успокоиться, устроиться
turn on/off - включать/выключать
point out - указывать
take on - брать на работу, браться за дело
fill in - заполнять, заделывать, вписать
turn down - убавлять, заворачиваться вниз
figure out - вычислять, понимать
wind up - довести, оказаться, завершить
think up - сочинять, придумывать
lie down - прилечь, проглотить обиду
follow through - довести до конца
work out - разработать, составить, добиться, тренироваться
put down - положить, опускать, высадить, подавить
carry on - продолжать
call off - отменять, откладывать, отзывать
check out - проверять, оценить
turn back - обернуться, повернуть назад
catch up - подхватить, догнать, наверстать
let out - выпускать, освобождать, проговориться
get in/out - входить/выходить, садиться в машину
be out - отсутствовать, выходить
stand by - быть готовым поддержать, подстраховать
take out - вынуть, вывезти
come off - оторваться, выпасть, выскочить
shut down - прикрыть, закрыть, опустить
go away - уйти, сбежать
wake up - будить, просыпатьс
shoot out - выскакивать, вылетать, высовывать, выпячивать
stand up - встать, стоять, отстоять, выдержать, удержаться
walk around - бродить, гулять
come up with - найти, разработать, придумать
break out - выломать, высыпать, вспыхнуть
watch out - Осторожно!, остерегаться
turn away - отворачиваться, отклонять, отвергать
play around - забавляться, кутить
stick with/to - придерживаться, соответствовать
hold on - Держись! удерживаться, цепляться
hand in - вручать, подавать
call back - перезванивать, звать обратно,
come about - происходить, случаться
find out - выяснить, узнать, раскрыть
get along - прожить, преуспеть, продвинуться
sit down - садиться, усаживаться, занять место
come on - Пойдем!, Давай!, возникать, приходить
set up - устанавливать, размещать, ставить, выдвигать
count on - рассчитывать на кого-л., что-л.
put a way - отложить, убрать, припрятать
look for - искать, подыскивать
come in - приходить, вступать
fool around - забавляться, дурачиться
get together - собраться вместе, встретиться
keep on - продолжать, не отставать
pull on - натягивать (чулки)
hand out - раздавать, тратить
show off - выставить в выгодном свете, покрасоваться
sit back - откинуться на спинку кресла
put up - выдвигать, поднимать
set down - отложить, высадить
get up - вставать, подниматься, взбираться
take off - убирать, снимать, сбавлять, уносить
put on - надевать, прибавлять, прикидываться, увеличивать
put in - вложить, вставить
end up - в итоге
keep away - остерегаться, держаться в стороне
put up with - смириться, стерпеть,
run off - убежать, удрать
be over - заканчиваться, оставаться
go out - выходить, выйти в свет, быть в обществе
be off - уйти, закончиться, просчитаться
shut up - закрыть, замолчать